#A## #A## #### #### ####
#B## 2A.. 0... 0..m ####
#BT# 1A.. 0... 0... ####
#AT# 0... 0... 5B.. #A##
#A## 0... 0..s 5B.. #A##
#A## #A## #A## #A## #A##
